111111111
11C0000E1
1001C1001
1P0C00011
111111111