111111111
110000001
100101001
100000011
111111111