11111111
100100C1
10000101
1P0011E1
11111111