11111111
1C000001
11000101
1P001E01
11111111