1111111
1P00E11
10C0011
1111111
