11111111
1C00C0C1
100C0101
1P001E01
11111111