1111111111111
1CP0011111111
1100010111111
100C00C0C0E11
1111111111111
