11111111
1C0000C1
100C0101
1P001E01
11111111