11111111111111111111
1P101C00100000110001
100001000010C000C001
10101000100100110C01
101C0100001C00010001
10C010001001C0110001
1010010C0010C0010111
1C1010001001C0110001
10100C000010C00100E1
11111111111111111111