11111111111111111111
1P101C00100000110001
10000100001000000001
10101000100100110C01
10100100001000010001
10101000100100110001
1010010C001000010111
1C101000100100110001
101000000010000100E1
11111111111111111111