11111111111111111111
1P101C00100000110001
1000010000100000C001
10101000100100110C01
10100100001000010001
101010001001C0110001
1010010C0010C0010111
1C1010001001C0110001
101000000010C00100E1
11111111111111111111